25,25,25,25,25,25,25,25,25,25,25,25,25,25,25,25,25,25,25,25,25,25,25,25,25,25,25,25,25,25,25,25,25,25,25,25,25,25,25,25,25,25,25,25,25,25,25,25
25,50,50,50,50,50,50,50,50,50,50,50,50,50,50,50,50,50,8,50,50,50,50,50,50,50,50,50,50,50,50,50,50,50,50,50,50,50,50,50,50,50,50,50,50,50,50,25
25,50,50,50,50,50,50,50,50,50,50,50,50,50,50,50,50,50,18,50,50,50,50,50,50,50,50,50,50,50,50,50,50,50,50,50,50,50,50,50,50,50,50,50,50,50,50,25
25,50,50,50,50,50,50,50,50,50,50,50,50,50,50,50,50,50,18,50,50,50,50,50,50,50,50,50,50,50,50,50,50,50,50,50,50,50,50,50,50,50,50,50,50,50,50,25
25,50,50,50,50,50,50,50,50,50,50,50,50,50,50,50,50,50,18,50,50,50,50,50,50,50,50,50,50,50,50,50,50,50,50,50,50,50,50,50,50,50,50,50,50,50,50,25
25,50,50,50,50,50,50,50,50,50,50,50,50,50,50,50,50,50,18,50,50,50,50,50,50,50,50,50,50,50,50,50,50,50,50,50,50,50,50,50,50,50,50,50,50,50,50,25
25,25,25,25,25,25,25,25,25,25,25,25,25,25,25,25,25,25,25,50,50,50,50,50,50,50,50,50,50,50,50,50,50,50,50,50,50,50,50,50,50,50,50,50,50,50,50,25
25,50,50,50,50,50,50,50,50,50,50,50,50,50,50,50,50,50,50,50,50,50,50,50,50,50,50,50,50,50,50,50,50,50,50,50,50,50,50,50,50,50,50,50,50,50,50,25
25,50,50,50,50,50,50,50,50,50,50,50,50,50,50,50,50,50,50,50,50,50,50,50,50,50,50,50,50,50,50,50,50,50,50,50,50,50,50,50,50,50,50,50,50,50,50,25
25,50,50,50,50,50,50,50,50,50,50,50,50,50,50,50,50,50,50,50,50,50,50,50,50,50,50,50,50,50,50,50,50,50,50,50,50,50,50,50,50,50,50,50,50,50,50,25
25,50,50,50,50,50,50,50,50,50,50,50,50,50,50,50,50,50,50,50,50,52,53,50,50,50,50,50,50,50,50,50,50,50,50,50,50,50,50,50,50,50,50,50,50,50,50,25
25,50,50,50,50,50,50,50,50,50,50,50,50,50,50,50,50,50,50,50,50,62,63,50,7,7,7,7,7,7,7,7,7,7,7,7,7,7,7,7,7,7,7,7,7,7,7,25
25,50,50,50,50,50,50,50,50,50,50,50,50,84,50,50,50,50,84,50,50,72,73,50,50,50,50,50,50,50,50,50,50,50,50,50,50,50,50,7,7,7,7,7,7,7,7,25
25,50,50,50,50,50,50,50,50,50,50,50,50,25,25,25,25,25,25,50,81,82,83,84,50,5,50,50,5,50,50,5,50,50,5,50,50,5,50,7,5,7,7,5,7,7,5,25
25,50,50,50,50,50,50,50,50,50,50,50,25,18,9,9,9,9,18,25,91,92,93,94,50,15,50,50,15,50,50,15,50,50,15,50,50,15,50,7,15,7,7,15,7,7,15,25
25,25,25,25,25,25,25,25,25,25,25,25,25,25,19,19,19,19,25,25,25,25,25,25,25,25,25,25,25,25,25,25,25,25,25,25,25,25,25,25,25,25,25,25,25,25,25,25
